HUMAN
	Peasant - models/creeps/lane_creeps/creep_good_ranged/creep_good_ranged.vmdl
	Militia - models/creeps/lane_creeps/creep_good_melee/creep_good_melee.vmdl
	Footman - models/heroes/dragon_knight/dragon_knight.vmdl
	Rifleman - models/heroes/sniper/sniper.vmdl
	Sorceress - models/heroes/lina/lina.vmdl
	Spell Breaker - models/heroes/silencer/silencer.vmdl
	Flying Machine - models/heroes/gyro/gyro.vmdl
	Dragonhawk Rider - models/heroes/skywrath_mage/skywrath_mage.vmdl
	Water Elemental - models/heroes/morphling/morphling.vmdl
	Phoenix - models/heroes/phoenix/phoenix_bird.vmdl + models/heroes/phoenix/phoenix_egg.vmdl
	Knight - models/heroes/legion_commander/legion_commander.vmdl
	Priest - models/heroes/oracle/oracle.vmdl
	Mortar Team - models/heroes/techies/techies.vmdl
	Siege Engine - models/items/courier/carty/carty.vmdl
	Gryphon Raider - models/courier/gryphon/gryphon.vmdl
		
ORC
	Peon - models/items/courier/dokkaebi_nexon_courier/dokkaebi_nexon_courier.vmdl (no attack animation)
	Grunt - models/creeps/lane_creeps/creep_bad_melee/creep_bad_melee_mega.vmdl (recolor green?)
	Headhunter/Berseker - models/heroes/huskar/huskar.vmdl
	Demolisher - models/items/courier/carty_dire/carty_dire.vmdl
	Shaman - models/heroes/blood_seeker/blood_seeker.vmdl
	Witch Doctor - models/heroes/witchdoctor/witchdoctor.vmdl
	Spirit Walker - models/heroes/spirit_breaker/spirit_breaker.vmdl
	Raider - models/heroes/chaos_knight/chaos_knight.vmdl
	Kodo Beast - models/courier/smeevil_mammoth/smeevil_mammoth.vmdl
	Wind Rider - models/items/batrider/firestarter_bat/firestarter_bat.vmdl
	Troll Batrider - models/heroes/batrider/batrider.vmdl
	Tauren - models/heroes/earthshaker/earthshaker.vmdl
	Spirit/Dire/Shadow Wolf - models/items/lycan/ultimate/thegreatcalamityti4/thegreatcalamityti4.vmdl 3 sizes
	
		
NIGHT ELF
	Wisp -	models/heroes/wisp/wisp.vmdl + particles/units/heroes/hero_wisp/wisp_ambient.vpcf
	Owl Scout - models/items/courier/snowl/snowl_flying.vmdl
	Hypogryph - models/items/mirana/mirana_nightsilver_owlion/mirana_nightsilver_owlion.vmdl
	Archer - models/heroes/windrunner/windrunner.vmdl
	Huntress - models/heroes/luna/luna.vmdl
	Glaive Thrower - models/creeps/lane_creeps/creep_good_siege/creep_good_siege.vmdl
	Dryad - models/heroes/enchantress/enchantress.vmdl
	Druid of the Claw - models/heroes/lone_druid/lone_druid.vmdl
	Mountain Giant - models/heroes/tiny_01/tiny_01.vmdl
	Druid of the Talon - models/heroes/furion/furion.vmdl
	Faerie Dragon - models/heroes/puck/puck.vmdl
	Chimaera - models/heroes/twin_headed_dragon/twin_headed_dragon.vmdl
	Treant - models/heroes/furion/treant.vmdl
	Avatar & Spirit of Vengeance - Check Warchasers
		
UNDEAD
	Acolyte - models/items/courier/boooofus_courier/boooofus_courier.vmdl
	Ghoul - models/heroes/life_stealer/life_stealer.vmdl
	Crypt Fiend - models/heroes/weaver/weaver.vmdl
	Gargoyle - models/heroes/visage/visage_familiar.vmdl
	Abomination - models/heroes/pudge/pudge.vmdl
	Meat Wagon - Dire Catapult
	Destroyer - models/heroes/obsidian_destroyer/obsidian_destroyer.vmdl
	Necromancer - models/heroes/warlock/warlock.vmdl
	Banshee - models/heroes/death_prophet/death_prophet.vmdl
	Infernal - models/items/warlock/golem/obsidian_golem/obsidian_golem.vmdl
	Skeleton Warrior - models/creeps/neutral_creeps/n_creep_troll_skeleton/n_creep_skeleton_melee.vmdl
	Skeletal Mage - models/heroes/pugna/pugna.vmdl
	Carrion Beetle - models/heroes/weaver/weaver_beetle.vmdl or models/heroes/weaver/weaver_bug.vmdl
	Frost Wyrm - Valve give Winter Wyvern
	




